#####
#S# #
# # #
#D#G#
#####

#####
#  U#
# ###
#  ##
#####
-----
#####
#S#*#
#*#*#
#D#G#
#####

#####
#**U#
#*###
#* ##
#####
