#################################
#                               #
#              #                #
#              #                #
#              #                #
#              #                #
#              #                #
#              #               G#
#S             #                #
#              #                #
#              #                #
#              #                #
#              #                #
#              #                #
#              #                #
#              #                #
#                               #
#################################
